5 13 31
###############################
#p    *   1   #       *       #
#     *   2   #   * * *1      #
#     *   x   #       *x   2  #
#     *   b   #   * * *  s    #
#     *       #     2 *    b  #
#*#*#*#*#*#*#*#*#*#*#*#*#*#*#*#
#     s       #       *   s   #
#     b       #       * * b * #
# # # f # # # #       *   2   #
#     f       #       * * 2 * #
#     x       #       *   f   #
###############################