3 13 31
###############################
#p    b*  *  1 *   *  * * *   #
# # # #*# # #*#*# # # #*#*#*# #
#  x*     ***  *  1   *   * * #
# # # # # #*# # #*#*# # # # #*#
#f         x **  *  *   1     #
# # # # # # # # # #*# #*# # # #
#*  *s     *  *      *     b  #
# # # # #*# # # #*#*# # # # # #
#*    **  *       *      2    #
# #*# # # # # # #*# # # # # # #
#    2      *   *  *          #
###############################