4 13 31
###############################
#p    b*  *  1 *   *  * * *   #
# **  ** *  ** *#  *# *   * s #
#  x*     ***  *  1   *   * * #
# # # # # #*# # #*#*# # # # #*#
#f         x **  *  *   1     #
# # # # # # # # # #*# #*# # # #
#*  *s x   *  *      *     b  #
# * * * * * * * * 1* 2* * * * #
#*    **  *       *      2    #
# #*# # # # # # #*# # # # # # #
#    2      *   *  *          #
###############################