2 10 31
###############################
#p   1      #                 #
# # # #*# # #*#*# # # #*#*#*# #
#  x*     ***  *     *    * * #
# # # # # #*# # #*#*# # # # #*#
#f         x **  *  *         #
# # # # # # # # # #*# #*# # # #
#*  *      *  *      *        #
# # # # #*# # # #*#*# # # # # #
###############################